59,59,59,59,59,59,59,59,59,59,59,59,59,59,59,59,59,59,59,59,59,59,59,59,59,59,59,59
59,59,59,59,59,59,59,59,59,59,59,59,59,59,59,59,59,59,59,59,59,59,59,59,59,59,59,59
59,59,59,59,59,59,59,59,59,59,59,59,59,59,59,59,59,59,59,59,59,59,59,59,59,59,59,59
59,59,59,59,59,59,59,59,59,59,59,59,59,59,59,59,59,59,59,59,59,59,59,59,59,59,59,59
59,59,59,59,59,59,59,59,59,59,59,59,59,59,59,59,59,59,59,59,59,59,59,59,59,59,59,59
59,59,59,59,59,59,59,59,59,59,59,59,59,59,59,59,59,59,59,59,59,59,59,59,59,59,59,59
59,59,59,59,59,59,59,59,59,59,59,59,59,59,59,59,59,59,59,59,59,59,59,59,59,59,59,59
59,59,59,59,59,59,59,59,59,59,59,59,59,59,59,59,59,59,59,59,59,59,59,59,59,59,59,59
59,59,59,59,59,59,59,59,59,59,59,59,59,59,59,59,59,59,59,59,59,59,59,59,59,59,59,59
59,59,59,59,59,59,59,59,59,59,59,59,59,59,59,59,59,59,59,59,59,59,59,59,59,59,59,59
59,59,59,59,59,59,59,59,59,59,59,59,59,59,59,59,59,59,59,59,59,59,59,59,59,59,59,59
59,59,59,59,59,59,59,11,15,15,15,15,15,15,15,15,15,15,15,15,15,15,10,59,59,59,59,59
59,59,59,59,59,59,59,17,00,00,00,00,00,00,00,00,00,00,00,00,00,00,14,59,59,59,59,59
59,59,59,59,59,59,59,17,00,28,30,30,30,30,27,00,28,30,30,30,27,00,14,59,59,59,59,59
59,59,59,59,59,59,59,17,00,32,59,59,59,59,29,00,32,59,59,59,29,00,14,59,59,59,59,59
59,59,59,59,59,59,59,17,00,38,31,31,31,31,37,00,38,31,31,31,37,00,14,59,59,59,59,59
59,59,59,59,59,59,59,17,00,00,00,00,06,00,00,00,00,00,00,00,00,00,14,59,59,59,59,59
59,59,59,59,59,59,59,17,00,28,30,27,00,28,31,31,31,27,00,28,27,00,14,59,59,59,59,59
59,59,59,59,59,59,59,17,00,32,59,29,00,32,59,59,59,29,00,32,29,00,14,59,59,59,59,59
59,59,59,59,59,59,59,17,00,38,31,37,00,38,30,30,30,37,00,38,37,00,14,59,59,59,59,59
59,59,59,59,59,59,59,17,00,00,00,00,00,00,00,07,00,00,00,00,00,00,14,59,59,59,59,59
59,59,59,59,59,59,59,12,16,16,16,16,16,16,16,16,16,16,16,16,16,16,13,59,59,59,59,59
59,59,59,59,59,59,59,59,59,59,59,59,59,59,59,59,59,59,59,59,59,59,59,59,59,59,59,59
59,59,59,59,59,59,59,59,59,59,59,59,59,59,59,59,59,59,59,59,59,59,59,59,59,59,59,59
59,59,59,59,59,59,59,59,59,59,59,59,59,59,59,59,59,59,59,59,59,59,59,59,59,59,59,59
59,59,59,59,59,59,59,59,59,59,59,59,59,59,59,59,59,59,59,59,59,59,59,59,59,59,59,59
59,59,59,59,59,59,59,59,59,59,59,59,59,59,59,59,59,59,59,59,59,59,59,59,59,59,59,59
59,59,59,59,59,59,59,59,59,59,59,59,59,59,59,59,59,59,59,59,59,59,59,59,59,59,59,59
59,59,59,59,59,59,59,59,59,59,59,59,59,59,59,59,59,59,59,59,59,59,59,59,59,59,59,59
59,59,59,59,59,59,59,59,59,59,59,59,59,59,59,59,59,59,59,59,59,59,59,59,59,59,59,59
59,59,59,59,59,59,59,59,59,59,59,59,59,59,59,59,59,59,59,59,59,59,59,59,59,59,59,59
